00100093
00200113
002081b3
001181b3
0100006f
00400093
0020c2b3
ffc00093
00800093
0000006f
